................................................................................................................
................................................................................................................
................................................................................................................
................................................................................................................
................................................................................................................
................................................................................................................
....................?.........................................?.............?...................................
.......o.................................................................................................o......
..BBBBBBBBBB......BBBBBB.........?..?..........?..?.........BBBBBB........BBBBBB.........?..?.......BBBBBBBBBB..
....PP...PP...........................................................................................PP...PP...
....PP...PP.....PP...........BBBBBBBBBBBB..BBBBBBBBBBBB...PP............PP...........BBBBBBBBBBBB.....PP...PP...
....PP...PP.....PPBBBBBBBB................................PPBBBBBBBB....PPBBBBBBBB....................PP...PP...
....PP...PP.....PP........................................PP............PP............................PP...PP...
.S..PP...PP.....PP....E..E.....E......E......E......E.....PP....E..E....PP....E..E.....E......E.......PP...PP.G.
################################################################################################################
################################################################################################################
